\.......................|..../.-.............\../........-.............\........../.-.\......|...../.......\..
.........../........./...-......-....\..........-................-./...........|.......|....|...\.............
..|..................\.................\./................\............................../...........|........
.....-....../............-........................-/..\..............|/..../.............................-....
.....\......./...|.||../.\......./..............|..\|...........-..\...........|..............................
.........-./.\....|....................\|........./......\...................|..............|....|.........../
....\..../.....-..........|./.......................|./...-...................-...||\...................../...
..|........|......||.....\........................-............................/..\...........................
.........|......./.......-...\|.....-/....|........|.............../.......\............\......\.........|...-
.....\...........................................././.......|..|...\.............-.........-....\/............
................-.............\.......\............./..\.|...........\..........................|.....-.......
../.......-.....|......\..........-...............//.....|../...-..............\./............................
................................................................................-........./......|.........-..
..\......\...|............................./......\-....\/.........//......................\....|-.\........\.
.........................................\-.......|........-................................................./
..................\...\..............|\.............|.....-./....../.\.........|.........-...............-....
.\.-./../......|./.....|/...\..........\.........|..-............................./..-........................
....................-.......-..\..\......../...........................................................\......
....-...|.....|/.......-.|........-..........|.\......................../......./.........\.-.................
........-../...../...........|....................-.-..-.............\.|..........|-/............-............
....../............\./.....-...|..............................-......./.-.................................|\./
.....|...........././-........./.............../...........|........./................\................./.....
\....--.............\.../....................\....\.....|.....|\.........-.....-.|.../......................./
.\........||............-....................\.../....../...../............-.......-....../..|......\..-...\..
.........|-........|.............../......................\..................................|...|............
....................../................-......\..............\......|...\..........\..//.....|................
-....-.|-.......|..............\....\...|........................-...........\.../..\..................../....
......-...................|........................|......|..........|...|..|................./....|.....\...|
..../......\........-...............................-........|......-........-.\........../..............|/...
....\........\........\....-........|......-.......\..........-./....-.|............|.-\.-..\......./....\....
.../.......\.../.|..../..//.........................//........................................................
..........................-................................|...............|....................\........./...
........./...|-./............/........|..............-..\/.....\|............\............................\|..
........../..\............\......-./\.|.|.....|.||-............-..................\...|.......................
....\...-................-.....-.......-....|..-....................../..............-.....\/...\....\........
......|.........\....|./..................|...-..........-...................................-....\..\..../...
.......|................/..........\.-........\....|..............\.../......../....-..../...\............/...
..--...........|........\........../........................./.................-..............................
.....|.-...............--.....................\.............\..............|./........./....-......./...\...|-
.......................................-........................\|..-.....................|...|....-.........|
.......-....|..........-..\......|\...........................\....\..........-........|..../........-\\......
......../-....\./..............\............................./.....\./...................\.................-/.
.\...../................|..|........./........\..|.../.../.\.-...../..\/...........|-\...\|.|...../......\....
......\.././......././........./..........././...../../......................-.|..\....|.........\.....-....\.
....................-.../..........-.............................-.........................................\-.
..........-......./..\...................../..............|......./...\.....\........|.............\..........
............................../...........|..........................\............-........././.\.............
......../.../.../...........|.../...\...........||-.../...|.../.\.|.-.................-./................../..
...\.......-...................-...../.......-..../.-..........-...\.........-..\.....................|.....\.
........../|.|..............................................\.........\..................|...........-..|.....
.....-...../..........|.........................................../........../....\.......\.....\......./.....
-.........../..|..|..................-....../....../..\......................./.....\|.../....................
........|..........|..........-.........../-..\-..\..\................/.../....................../...........-
...|....................../......-\...|......./....|.........|.................|./.-../..|\../................
.|..-............-.......|../\.\........./....-....../..|..................-.........|.............\..........
-.....|...../................................|/...................\..-..................-.../..|.....-........
.-....|....\../-......................-.....|.....|./......--...........-...|......|/|..-.....................
................/........../...........\|........./........../............-../|../......|....\................
...//.....\........|/............|........-../..-../...\.......-.../................./........................
....|.....|../...\.......\......./.......\......\.../................\....................-..............-..\.
..-...........-..-..--...\..........-|/......./................/|.......//.-..........|.........-../..|.......
.....|......../............|..-.........\\....................-....|.......|.................................\
...................-......|...\.........\......-...../............\........|........|........./..../..........
..../...-...-...\-.......\.................|..-.........\-......|..|.........|.....-..................\.......
................/..........................|..........\.\.....-......\......\............................|-.-.
.........\-......-......../-....-..........\-.........../|..............-....\................................
..../.....................\.\........-....................../.....\.|................................./\.\.../
.\............/..\...--..........................................--.....................-.././....\.........|.
..-/...........................|..../...\..\........................................................./../.....
.......|-............./.........................../......\..................|........|...........|../..\......
...........|.....-.....\...../........................./...................|..../....|....../..\..........-...
../.......-........\../...............................\...-......../...-.....\................../.......|.....
......................../.......\.....................|..........\.|/....-|........................-.\.....\..
........\..|............/............./||................|.......................|.......-....................
........................\\....|......|....|.........-........-...\.../.......................\-..............\
...............................................................\-.............-......././..\..../.............
.......\.............-........-............-................|..-........|.............-....-..|...............
|........-...../..|.......-............\..-..................|....\.................|......../.\....|-...|....
...-....../.......................\...............|.-......-...........|........./......./.../..-.........-...
......../...............-....\....................|./..................-..../........|/.............-../-.....
...................../............|....-/.........-....................-.........|...................../......
...../.................././............./.|............-..........................................\.../.......
..-......\............|.|.../......-......\.......-........|...\.........../................................/.
...........-..-..\.............-..../.........................\.......-|.....-/..-..-........|./........../...
..\..........|\-..../\-...................|...-........\...............-....|.................................
..-...................\|.......\.-......../......\.........................-....\........./|........|.........
......../......-.....|................\.............................-...|.................../||.....-.........
.........-....\...|.../..........................\..............\................\...../......................
../...............\............................\....|..-....../......../........./............................
................................................./\......../....|.......\...\...../...............|...........
............|.-.....|\\......|.-.............../.....|...-..........................\.......|..-............|.
...............-..........-.............................../....................................\......\......-
-.\........\...........-........../.\...............\.......................|...................\..../........
...\......\.../....................................-...............|...-..........|...........\.....-.........
.......................|......\.../........../....................\...../...../...............................
\.|......\.........|...........................||......|.-......./.-.........-.........-......................
....|....\....../..............|.|....................-.....|......./\..../......|.......\....................
.....-.................\\....-...........\..............\......../...................................../....|\
............|....|........./......|.......|..|......../.................-........................./.......-..|
...........\.........|.|......................\............\...................................|.......-......
........./.............../.................................../....................../.........-.......|...-...
..\.....\..............|.....|............../..|..................|\./.........\..............................
..|...|......................././|.......................\.../-..\..../..../......./.|........\........|......
...........-.|...|........./..-...........................-|.|......................\..........\..............
.......................................|......-/...\..../.../...................../..............-............
.........../...........|................|........./.................--.............-.....................-...|
.\\.-................................|.-........................................./.........../\...............
|..\...........................................|.......|..................../.................................
.....|.\.......-........\......|.-.......................................|...........\................\\\|.../
...............--.....................-.......\...................\..-...........................\.........|.\
